XXXXXXXXXXXXXXXXXXXXXXXXXXXXXXXXXXXXXXXXXXXXXXXXXXXX
X                                                  X
X                                                  X
X                                                  X
X                                C                 X
X                             XXXXXXX              X
X                                                  X
X                                                  X
X                                                  X
X    S                                        G    X
XXXXXXXXXXXXXXXEEEEEXXXXXXXXXXXXXXXXXXXXXXXXXXXXXXXX
XXXXXXXXXXXXXXXXXXXXXXXXXXXXXXXXXXXXXXXXXXXXXXXXXXXX