XXXXXXXXXXXXXXXXXXXXXXXXXXXXXXXXXXXXXXXXXXXXXXXXXXXXXXXXXXXXXXXXXXXXXXXXXX
X                                      X                                 X
X                                      X                                 X
X                                      X                                 X
X                                      X                                 X
X                                      X                                 X
X                                      X                                 X
X                                                                        X
X                                                                 C      X
X                                     XXX     XXX                XXX     X
X                    XXX       XXX     X              XXX    X           X
X                                      X                                 X
X                                      X                                 X
X           XXX                        X                                 X
X                                      X                                 X
X                                                                        X
X                                                                        X
X   S               E                  X                                 X
XXXXXXXXXXXXXXXXXXXXXXXXXXXXXXX   XXXXXXXXXXXXXXXXXXXXXXXXXXXXXXXXXXXXXXXX
X    X              X             X              X                X      X
X                                 X              X                X      X
X            X             X      X              X       X               X
X      XXXXXXXXXXXXXXXXXXXXXXXXXXXX      X       X       X            G  X
X                                        X               X           XXXXX
X                                        X               X               X
XXXXXXXXXXXXXXXXXXXXXXXXXXXXXXXXXXXXXXXXXXXXXXXXXXXXXXXXXXXXXXXXXXXXXXXXXX