XXXXXXXXXXXXXXXXXXXXXXXXXXXXXXX                              
X                             X                              
X                             X                              
X   XXXXXXXXXXXXXXXX          X                              
XX                            X                              
X                             X                              
X                             X                              
X                             X                              
X                             X                              
X                             X                              
X   XXXX                      X                              
X                             X                              
X                          G  X                              
X           EEEEEEEEEXXXXXXXXXX                              
X           X                 X                              
X           X                 X                              
X           X                 X                              
X      XXXXXX    XXXX         X                              
X      EEEEEE    X            X                              
X                X            X                              
X                X            X                              
XXXXXXXXXXXXXXXXXX            XXXXXXXXXXXXXXXXXXXXXXXXXXXXXXX
X                 X                  EE         EE          X
X                  X                                        X
X                   X                                       X
X                    X                                      X
X                     X                                     X
X                      X                                    X
X                       X                                   X
X                        X           EE         EE          X
X                         X          EE         EE          X
X                          X         EE         EE          X
X                           X        EE         EE          X
XXXXXXXXXXXXXXXXXXXXXXXXXXXXXXXXXXXXXXXXXXXXXXXXXXXXXXX     X
                              X                             X
                              X                             X
                              X                             X
                              X                             X
                              X    XXXX   XXXX              X
                              X                          XXXX
                              X                             X
                              X                             X
                              X                    XX       X
                              XXXXX                         X
                              X                           C X
                              X                          XXXX
                              X                             X
                              X     XXXX                    X
                              X                             X
                              X                             X
                              X            XXXX             X
                              X                             X
                              X                             X
                              X       S                     X
                              X      XXX                    X
                              X                             X
                              XEEEEEEEEEEEEEEEEEEEEEEEEEEEEEX
                              XXXXXXXXXXXXXXXXXXXXXXXXXXXXXXX